|-----------------------------------------------------------------------------|
|                                                                             |
| |----------------|  |-|----|        |--|    |-------| |--|   --|            |
| |................|  |.|....+#####   |..|    |.......| |..|   |.|            |
| |................|--|.|..|--    #   |..|----|.......|-|..|-|||.| |--|       |
| |........................|      #   |..........|-|.............| |..|--|    |
| |........................|      #   |..........| |.............|-|.....|--| |
| |....|-|...|-|......|-----      #   |----+-----| |--------|...............| |
| |....| |...| |......|     --  ############                |...............--|
| |----| |---| |------|     -|  #    |--------+------|         |........|-|...|
|                        #      #    |...............|         |........| |...|
|                        #      #    |...............+#########|-|......| |...|
|       |-|  #####################   |...............|      |..| |......| |.| |
|       |.|  #              #    #   |-----+-|.|--|         |--| |---+--| |-| |
|  |----|.|--+-----------|  #    #         # |.|                     #        |
|  |.....................|  #    #         # |-|   |------|   |------+------| |
|  |.....................|  #    ###########       |......|   |.............| |
|  |.....................|  #              #       |......|   |--...........| |
|  |.....................|  #       |-| |--+|      |.....| |----|...........| |
|  |.....................|  #       |.| |...|    |-|.....| |...........|----- |
|  |-|...................+##########+.|-|...|----|.......|-|...........|      |
|    |...................|          |...................---------------|      |
|    |-------------------|          |-------------------                      |
|                                                                             |
|-----------------------------------------------------------------------------|
