|-----------------------------------------------------------------------------|
|                                                                             |
| |--|   |---|   |---|    |--|         |-|-| |-|    |-|    |--|               |
| |..|   |...|   |...|    |..+#####    |.|.| |.|    |.|    |..|               |
| |----|-|...|-|-|...|--------    #    |.|.|-|.|  |-|.|----|..|-------|       |
|   |......................|      #   |........| |..|-|...............|--|    |
| --|......................|--    #   |........|-|..| |..................|    |
| |...|-|--|......|-|........|    #   |----+--------| |.|---|............|    |
| |.....|  |......| |........|  ############          |.|   |............| |--|
| |-----|   |.||.|  |.|--+---|  #        |--------------|       |-|......| |..|
|           |.||.|  |.|  #      #  |-|     |.||......|            |......|-|..|
|           |----|  |-|  #      #  |.|-|-|||.||......+#########+| |....|-|.|..|
|   |-|      ##################### |--...............|      |...| |....| |.|  |
|   |.|      #              #    #   |-|.|-+--|.|-|          |.|  |--+-| |-|  |
|   |.|    |-+-| |-| |---|  #    #     |.| #  |.|            |.|     #        |
||-||.|    |...| |.| |...|  #    #     |-| #  |-----| |---|----|    |+| |---| |
||.||.|-|  |...|-|.| |...|-|#    ###########     |..| |.....||-|    |.| |.|-- |
||.|....| |........| |.....|#              #     |..| |--.--||.|----|.|-|.|   |
||.|....|-|........|-|...--|#       |---| |+| |--|..|  |-- |-|.||.........|-  |
||-|.....................|  #       |...| |.| |.....|-|    |-|...........|-|  |
|  |----|-|-|......|-|...+##########+...|-|.|-|........|---| |...........|    |
|           |......| |...|          |...................|.|   |.|--|.||.|     |
|           |------| |---|          |-------------------|.|   |.|  |.||.|     |
|                                                       |-|   |-|  |----|     |
|-----------------------------------------------------------------------------|
