|-----------------------------------------------------------------------------|
|                                                                             |
| |------| |---|    |--------|        |-----| |---------| |---|               |
| |......| |...|    |........+#####   |.....| |.........| |...|               |
| |......|-|...|----|......|--    #   |-|...|-|.........|-|-|.|-------|       |
| |........................|      #     |.........|-|...|-  |.........|--|    |
| |........................|--    #   --|.........| |...| --|............|--| |
| |......|-|.................|    #   |----+------| |---| |-|...............| |
| |......| |.................|  ############                |...............--|
| |------| |-------------+---|  #    |--------+------|         |..............|
|                        #      #    |...............|         |..............|
|                        #      #    |...............+#########+..|-|.........|
|            #####################   |...............|      |.....| |.......| |
|            #              #    #   |-----+-|.|--|         |-----| |+------| |
|      |-----+-----------|  #    #         # |.|-|                   #        |
|      |.................|  #    #         # |-|.|-----|      |------+------| |
|  |---|.................|  #    ###########   |.|-|...|      |.............| |
|  |.....................|  #              #   |.  |...|-|    |--...........| |
||--.....................|  #       |------+---|.--|.....-------|...........| |
||.......................|  #       |...................|-|.....|-|.......|-- |
||--...|-|....|-|-|..|-|.+##########+............|-|....| |.....| |.......|   |
|  |...| |....|   |..| |.|          |............| |....| |---|.|  |.|----|   |
|  |---| |----|   |--| |-|          |------------| |----      |.|  |.|        |
|                                                             |-|  |-|        |
|-----------------------------------------------------------------------------|
