|-----------------------------------------------------------------------------|
|                                                                             |
| |-| |--------|    |-| |----|         |----------| |-----| |-|               |
| |.| |........|    |.| |....+#####    |..........| |.....| |.|               |
| |.|-|........|----|.|-|....|    #    |--........|-|.....|-|.|-------|       |
| |....|-|...................|    #   |...........|----|..............|--|-|  |
| |....| |.................|--    #   |...........|    |...................|  |
|  |---|  |..........|-|...|      #   |----+------|    |----|............--|  |
|         |..........| |...|--  ############                |............|-|--|
|         |--|.|---|.| |-+-|.|-|#    |--------+------|         |..............|
|            |.|   |.|   # |...|#  |--...............|         |..............|
|            |-|   |-|   # |---|#  |...|-|...........+#########+|-|...|-|.....|
|  |-|       ##################### |--.| |...........|      |...| |...| |...| |
|  |.|       #              #    #   |.|-|-+------|     |-|  |.|  |--+| |---| |
|  |.| |-----+-----| |---|  #    #   |...| #            |.|  |.|     #        |
|  |.| |...........| |...|  #    #   |---| #     |------|.|  |--   |-+------| |
|  |.|-|...........|-|...|-|#    ########### |-| |........| |-|    |....|---- |
|  |.......................|#              # |.| |-|......| |.|    |....|     |
|  |.......|-|...|-|.....--|#       |---| |+-|.|   |.....---|.|-|  |....|---- |
|  |.......| |...| |.....|  #       |...| |....| --|....|-|...|----|.|----|.| |
|  |.||.|-|  |-|.| |.|-|.+##########+|----|.|----|-|.|..| |...| |....|    |.| |
|  |.||.|      |.| |.| |.|             |....| |..| |.|..| |-|.| |.||.|    |-| |
|  |----|      |-| |-| |-|             |----| |--| |-|--    |.| |.||.|        |
|                                                           |-| |----|        |
|-----------------------------------------------------------------------------|
