|-----------------------------------------------------------------------------|
|                                                                             |
| |---------------| |---| |--|        |-------|     |-|-------| |-|           |
| |...............| |...| |..+#####   |.......|     |.|.......| |.|           |
| |...............|-|...|-|..|    #   |.......|-----|.|.......|-|.|---|       |
| |..........................|    #   |.......|----|....|-|...........|--|    |
| |..........................|    #   |.......|    |....| |..............|--| |
| |-|........................|    #   |----+--|    |----| |-|...............| |
|   |........................|  ############                |...............--|
|   |----|.|------|.||.|-+---|  #    |---| |--+---|            |..............|
|        |.|      |.||.| #      #    |-|.| |......|            |..............|
|        |-|      |----| #      #      |.|-|......|-|+#########+..............|
|            #####################   --|.............|      |...............| |
|            #              #    #   |-----+-|.|--|         |--------+------| |
|          |-+| |--------|  #    #         # |.|                     #        |
|          |..| |........|-|#    #         # |-| |--------|     |----+-|      |
|  -----|  |..|-|..........|#    ########### |---|-|......|     |-|....|      |
|  |....| |..............--|#              # |...  |......|       |....|---|  |
||--....|-|..............|  #       |------+-|--.--|.....-----| --|.........| |
||.......................|  #       |.......................|-| |..|-|......| |
||-|-|....|-|...|-|......+##########+.......................| |-|..| |......| |
|    |....| |...| |......|          |...................----| |.|--| |.|-|.|  |
|    |----| |---| |------|          |-------------------      |.|    |.| |.|  |
|                                                             |-|    |-| |-|  |
|-----------------------------------------------------------------------------|
