|-----------------------------------------------------------------------------|
|                                                                             |
| |--------------------------|        |------| |-----------------|            |
| |..........................+#####   |......| |..............||.|            |
| |..........................|    #   |......|-|..............||.|-|          |
| |..........................|    #   |............................|  |--|    |
| |........................|--    #   |............................|-|...|--| |
| |........................|      #   |----+----------------|...............| |
| |........................|--  ############                |...............--|
| |----------|.||.|-|.|--+---|  #    |--------+------|         |..............|
|            |.||.| |.|  #      #    |...............|         |..............|
|            |----| |-|  #      #    |-|.............+#########+......|-|.....|
|            #####################     |.............|      |.........| |...| |
|            #              #    #     |---+------|         |---|.|--+| |---| |
|  |---------+| |-| |----|  #    #         #                    |.|  #        |
||--..........| |.| |....|  #    #         #     |--------|     |-|--+| |---| |
||............|-|.|-|....|  #    ###########     |......|--       |...| |...| |
||--.....................|  #              #     |......|       --|...|-|...| |
||.......................|  #       |--| |-+-----|......|---| |-|...........| |
||.|.....................|  #       |..| |..................| |.............| |
||.|..|-|..|-|...........+##########+..|----|...............|-|.............| |
||-|..| |..| |...........|          |.....| |...........------------|.|-----| |
|  |--| |--| |-----------|          |-----| |-----------            |.|       |
|                                                                   |-|       |
|-----------------------------------------------------------------------------|
