|-----------------------------------------------------------------------------|
|                                                                             |
| |-------------| |-----| |--|      |----------| |------------|     |-|       |
| |.............| |.....| |..+##### |..........| |............|     |.|       |
| |.............|-|.....|-|..|    # |--........|-|............|-----|.|       |
| |..........................|    #   |........|-|..|-|...............|       |
| |..........................|    #   |........| |..| |...............|  |--| |
| |...........|-|............|    #   |----+---| |--| |-----|.........|-|...| |
| |...........| |............|  ############                |...............--|
| |------|.|--| |--------+---|  #    |-| |----+------|         |..............|
|        |.|             #      #    |.| |...........|         |..............|
|        |-|             #      #    |.|-|...........+#########+......|-|.....|
|            #####################   |...............|      |.........| |...| |
|            #              #    #   |.|---+------|  |-|    |--------+| |---| |
|  |------| |+---| |-| |-|  #    #   |.|   #         |.|             #        |
|  |......| |....| |.| |.|  #    #   |-|   #     |---|.|--|     |----+------| |
|  |......|-|....|-|.|-|.|  #    ########### |-| |........|     |...........| |
|  |.....................|  #              # |.| |........|     |...........| |
|  |.....................|  #       |------+-|.|-|.......-------|.........|-- |
|  |.....................|  #       |.....................................|   |
|  |......|----|.........+##########+..............|-|....................|-- |
|  |......|    |.........|          |..............| |..----|.|-------------| |
|  |------|    |---------|          |--------------| |--    |.|               |
|                                                           |-|               |
|-----------------------------------------------------------------------------|
