|-----------------------------------------------------------------------------|
|                                                                             |
| |--| |------------------|           |--| |-----| |----------|               |
| |-|  |..................| |+#####   |..| |.....| |..........|        |-|    |
|    |-|..................|-|     #   |..|-|.....| -|.........|  |----||.|    |
| --|........................|    #   |.....|-|.|-  |..|-|.....| |....||.|    |
| |..........................|    #   |.....| |.| --|..| |.....|-|.......|--| |
| |..............|---|....|----|  #   |----+| |-| |----| |--|...............| |
| |..............|   |....| |..|############                |...............--|
| |.|------------|   |---+| |--|#    |--------+------|         |..............|
| |.|                    #      #  |--...............|         |..............|
| |-|                    #      #  |.................+#########+..............|
|        |-| ##################### |--...............|      |...............| |
|        |.| #              #    #   |-----+------|    |-|   |.|-----+------| |
|  |-----|.|-+-----------|  #    #         #           |.|   |.|     #        |
|  |.....................|  #    #         #       |---|.|   |-------+| |---| |
|  |.....................|  #    ###########       |......|  |-||.....| |...| |
|  |.....................|  #              #     --|......|  |.||.....|-|.|-- |
|  |.....................|  #       |------+-----|.......----|.||.........|   |
|  |.....................|  #       |...................|-|...............|-- |
|  |-|...................+##########+.....|----|...|-|..| |.................| |
|    |...................|          |.....|    |...| |..| |-----------------| |
|    |-------------------|          |-----|    |---| |--                      |
|                                                                             |
|-----------------------------------------------------------------------------|
