|-----------------------------------------------------------------------------|
|                                                                             |
|   |--------| |--| |----| |-|        |-|-|        |--|   |---------|         |
|   |........| |..| |....| |.+#####   |.|.|         |--   |...||.||.|         |
| |-|........|-|..|-|....|-|.|    #   |.|.|-|------|   ---|...||.||.|-|       |
| |........................|--    #   |.............| -...|-|.........|--|    |
| |-|......................|      #   |.............| |...| |............|    |
|   |......|-|.............|--    #   |----+--------| |---| |............|    |
| --|......| |...............|  ############                |............|-|--|
| |--------| |-----------+---|  #  |----------+------|         |..............|
|                        #      #  |.................|         |..............|
|                        #      #  |--...............+#########+..............|
|  |-|       #####################   |...............|      |...............| |
|  |.|       #              #    #   |-|.|-+--|.|-|         |--------+------| |
|  |.| |-| |-+-----------|  #    #     |.| #  |.|                    #        |
|  |.| |.| |...........|--  #    #     |-| #  |--------|           |-+------| |
||--.|-|.|-|...........|    #    ###########   |-|.....|      |-|  |........| |
||.....................|-   #              #   |.|.....|-|    |.||-|........| |
||--........|-|.......|-|   #       |------+-| |.|.......-----|.|...........| |
|  |........| |.......|     #       |........| |.....................|-|....| |
|  |........| |..|-|..| |+##########+..|-|...|-|-|...................| |....| |
|  |........| |..| |..|             |..| |.....| |......--------|.|--| |----| |
|  |--------| |--| |--|             |--| |-----| |------        |.|           |
|                                                               |-|           |
|-----------------------------------------------------------------------------|
