|-----------------------------------------------------------------------------|
|                                                                             |
| |---------------|   |------|        |---------| |-------| |-|               |
| |...............|   |......+#####   |-|.......| |.......| |.|               |
| |...............|-|-|..|----    #     |.......|-|.......|-|.|--| |--|       |
| |-|....................|        #   --|..........|----|........| |..|--|    |
|   |....................| |--    #   |............|    |........|-|.....|--| |
| --|....|-|..|-|.|-|....| |.|    #   |----+-------|    |---|...............| |
| |......| |..| |.| |....|-|.|  ############                |...............--|
| |----|.| |--| |-| |----+|.|   #    |--| |---+------|         |..............|
|      |.|               #|.|   #    |..| |..........|         |..............|
|      |-|               #|-|   #    |..|-|..|-|.....+#########+.|-|.....|-|..|
|    |-|     #####################   |.......| |.....|      |....| |.....|    |
|    |.|     #              #    #   |-|.|-+-| |.|------|   |----| |-+---|    |
|  |-|.|--| |+----|    |-|  #    #     |.| #   |.| |.||.|            #        |
|  |......| |.....|    |.|  #    #     |-| #   |.|-|.||.|-|     |----+---|    |
|  |-|....|-|.....|----|.|  #    ###########   |.|......|--     |........|    |
|    |...................|  #              #   |-|......|       |........|-|  |
|  --|...................|  #       |------+---| |......|-------|-|.....|---  |
|  |-|...................|  #       |..........| |............|-  |.|-|.|     |
|    |...|-|..|-|........+##########|-|........|-|............| --|.| |.|---- |
|  --|...| |..| |........|            |.................------| |---| |.|---| |
|  |-----| |--| |--------|            |-----------------              |.|     |
|                                                                     |-|     |
|-----------------------------------------------------------------------------|
