|-----------------------------------------------------------------------------|
|                                                                             |
|   |---------| |-----| |----|        |---| |---| |--------------| |-|        |
|   |.........| |.....| |....+##### |--...| |...| |...........||.| |.|        |
| |-|.........|-|.....| |....|    # |.....|-|...|-|...........||.|-|.|        |
| |...................| |....|    # |--|-|............................|--|    |
| |...................|-|....|    #      |...............................|--| |
|  |-|...............|-|..|-|     #      |-+----------------|...............| |
|    |...............| |..|     ############                |...............--|
|     |.|----|.|-----| |-+|     #  |---| |----+| |---|         |..............|
|     |.|    |.|         #      #  |...| |.....| |...|         |..............|
|     |-|    |-|         #      #  |--.|-|...|-|-|...+#########+..............|
|  |-|    |-|#####################   |.......| |.....|      |...............| |
|  |.|    |.|#              #    #    |.|--+-| |.|          |-|.|----+------| |
|  |.|  |-|.|+-----------|-|#    #    |.|  #   |.|            |.|    #        |
|  |.|  |.|................|#    #    |-|  #   |-|---| |--|   |.|----+--| |-| |
|  |.|--|.|..............--|#    ###########   |-|...|  |-- |-|.|.......| |.| |
|  |.....................|  #              #   |.|...|-|    |.|-|.......|-|.| |
|  |.....................|  #       |------+---|.|......|---|.| |...........| |
|  |.....................|  #       |.....................|-|.| |....|-|....| |
|   |-|..|-|...|-|.|-|...+##########+...............|-|...| |.|-|....| |....| |
|     |..| |...| |.| |...|          |...............| |.--| |--------| |----| |
|     |--| |---| |-| |---|          |---------------| |-                      |
|                                                                             |
|-----------------------------------------------------------------------------|
