|-----------------------------------------------------------------------------|
|                                                                             |
| |----|  |---| |------------|           |----------| |-|  |-| ----|          |
| |....|  |...| |............+#####      |..........| |.|  |.| |...|          |
| |....|--|--.| |............|    #    |-|..........|-|.|--|.|||--.|--|       |
| |...........| |............|    #   |-|-|...........|-|--|..........|--|    |
| |-|.........|-|............|-|  #       |.............|  |.............|--| |
|   |..|-|.....................|  #       |+------------|   |...............| |
|  -|..| |...................--|############                |...............--|
|  |.|-| |----|.|-|---|.|+-|.|  #    |--------+------|         |..............|
|  |...|      |...|   |.|# |.|  #  |--...............|         |..............|
|  |---|      |---|   |-|# |-|  #  |...|-|...........+#########+|-|......|-|..|
|       |-|  ##################### |--.| |...........|      |...| |......|    |
|       |.|  #              #    #   |-| |-+-|.|--|    |-|-||.|-| |--+---|    |
|  |----|.|--+----| |----|  #    #         # |.|       |...||.|      #        |
|  |..............| |....|  #    #         # |.| |---| |.-----| |-| |+------| |
|  |-|............|-|....|  #    ########### |.| |...| |..||-|  |.| |.......| |
|    |...................|  #              # |-| |...|-|..||.|  |.|-|.......| |
|  --|...................|  #       |------+--|  |.......| |.|  |...........| |
|  |.....................|  #       |.........| |........| |.| |.|----|..|-|  |
|   |-|..............|-|.+##########+.........|-|...|-|..|-|.|-|.|    |..|    |
|     |..............| |.|          |...............| |.---------|    |--|    |
|     |--------------| |-|          |---------------| |-                      |
|                                                                             |
|-----------------------------------------------------------------------------|
