|-----------------------------------------------------------------------------|
|                                                                             |
| |------------------| |-----|        |-----------| |---------|     |-|       |
| |..................| |.....+#####   |...........| |.........|     |.|       |
| |-|................|-|.....|-|  #   |...........|-|.........|-| |-|.|       |
|   |..........................|  #   |.|-|..........|-|.|-|....| |...|--|    |
| --|........................--|  #   |.| |..........| |.| |....|-|......|--| |
| |..........................|    #   |-| |+---------| |-|  |...............| |
| |..........................|  ############                |...............--|
| |---|.|----|.|--|.|----+---|  #    |-----| |+------|         |..............|
|     |.|    |.|  |.|    #      #    |.....| |.......|         |..............|
|     |-|    |-|  |-|    #      #    |.....|-|.......+#########+.|-|..........|
|            #####################   |...............|      |....| |........| |
|            #              #    #    |.|--+------|         |----| |-+------| |
|  |---------+-| |-------|  #    #    |.|  #                         #        |
|  |...........| |.......|  #    #    |-|  #     |--------|       |--+------| |
|  |-|.........|-|.......|-|#    ###########     |........|       |.......|-- |
|    |.....................|#              #     |........|     |-|.......|   |
|  --|...................--|#       |------+--|  |.......-------|.........|-- |
|  |-|...................|  #       |.........| |...........................| |
|    |.|----|.........|-|+##########+.........|-|...........................| |
|  --|.|    |.........|             |...................---------|.|--------| |
|  |---|    |---------|             |-------------------         |.|          |
|                                                                |-|          |
|-----------------------------------------------------------------------------|
