|-----------------------------------------------------------------------------|
|                                                                             |
|    |-| |---------| |-------|          |---------------| |---|               |
|    |.| |.........| |.......+#####     |...............| |...|               |
|  |-|.|-|.........|-|.......|    #   --|...............|-|...| |-|---|       |
| |..........................|    #   |.......|-|.............| |.|...|--|    |
| |..........................|    #   |.......| |.............|-|.|......|--| |
| |..........|-|.............|    #   |----+--| |------|.|--|...............| |
| |..........| |.............|  ############           |.|  |...............--|
| |-|.||.||.|  |---------+---|  #    |-----| |+--| |-| |-|     |..............|
|   |.||.||.|            #      #    |.....| |...| |.|         |..............|
|   |--|.||-|            #      #    |.....|-|...|-|.+#########+|-|-|.........|
|      |.|   #####################   |...............|      |...|   |.......| |
|      |-|   #              #    #   |-----+------| |-|     |---|   |+------| |
|    |-------+-----------|  #    #         #        |.|              #        |
|    |.................|--  #    #         #      |-|.|---|         |+------| |
|  |-|.................|    #    ########### |-|  |.|.....|         |.......| |
|  |...................|--  #              # |.|  |.|.....|     |---|.......| |
|  |.....................|  #       |------+-|.|-|.......-------|...........| |
|  |.....................|  #       |......................|-|..|-|.........| |
|  |.....................+##########+......................| |..| |.........| |
|  |.....................|          |...................---| |--| |---------| |
|  |---------------------|          |-------------------                      |
|                                                                             |
|-----------------------------------------------------------------------------|
